=========  =========
=..................=
=.                .=
=.                .=
=.                .=
=.================.=
=.=*............*=.=
=.=======..=======.=
=.      ==.=      .=
=.      =..=      .=
=.      =.==      .=
=.      =..=      .=
=.                .=
=.                .=
=.                .=
=.                .=
=                 .=
=.                .=
=..................=
=========  =========
