=========..=========
=..*..............G=
=.=.============.=.=
=.=.=...====...=.=.=
=.=...=......=...=.=
=.================.=
=.=*......G.....*=.=
=.=======..=======.=
=.......==.=.......=
=.=====.=..=.=====.=
  ......=.==......  
=.=====.=..=.=====.=
=.=g..=......=g..=.=
=.=...=.====.=...=.=
=.=..............=.=
=.=...=.====.=...=.=
=.=*..=.=  =.=..*=.=
=.=====.====.=====.=
=.....hHh..........=
=========..=========
